start 1 1
1 2 1
2 1 1
1 6 1
6 1 1
2 3 1
3 2 1
2 4 1
4 2 1
4 5 1
5 4 1
6 7 1
7 6 1
7 9 1
9 7 1
9 10 1
10 9 1
10 11 1
11 10 1
10 12 1
12 10 1
12 13 1
13 12 1
12 15 1
15 12 1
13 14 1
14 13 1
14 19 1
19 14 1
16 17 1
17 16 1
16 19 1
19 16 1
17 18 1
18 17 1
19 20 1
20 19 1
20 21 1
21 20 1
21 end 1
